
0;1;1;1;0;
1;0;0;1;1;
1;0;0;0;1;
1;1;0;0;0;
0;1;1;0;0;
# 2 Weg Matrix;5;x;5
3;1;0;1;2;
1;3;2;1;0;
0;2;2;1;0;
1;1;1;2;1;
2;0;0;1;2;
# 3 Weg Matrix;5;x;5
2;6;5;4;1;
6;2;1;4;5;
5;1;0;2;4;
4;4;2;2;2;
1;5;4;2;0;
